est_ttl,est_ttl_ml_sub5,est_ttl_ml_sub10,est_ttl_ml_sub15,est_ttl_fl_sub5,est_ttl_fl_sub10,est_ttl_fl_sub15,id,Geographic Area Name,elem,mdl
665,0,19,23,0,0,8,1500000US530530602001,"Block Group 1, Census Tract 602, Pierce County, Washington",19,31
1371,14,11,0,14,26,20,1500000US530530603001,"Block Group 1, Census Tract 603, Pierce County, Washington",37,20
1140,73,0,47,0,42,50,1500000US530530603002,"Block Group 2, Census Tract 603, Pierce County, Washington",42,97
1655,61,11,12,34,60,43,1500000US530530603003,"Block Group 3, Census Tract 603, Pierce County, Washington",71,55
709,11,58,7,21,29,10,1500000US530530604001,"Block Group 1, Census Tract 604, Pierce County, Washington",87,17
697,18,35,9,14,30,0,1500000US530530604002,"Block Group 2, Census Tract 604, Pierce County, Washington",65,9
811,28,20,55,31,36,14,1500000US530530604003,"Block Group 3, Census Tract 604, Pierce County, Washington",56,69
1035,16,53,35,0,0,6,1500000US530530604004,"Block Group 4, Census Tract 604, Pierce County, Washington",53,41
757,37,31,6,19,44,16,1500000US530530604005,"Block Group 5, Census Tract 604, Pierce County, Washington",75,22
728,11,21,29,22,51,0,1500000US530530605001,"Block Group 1, Census Tract 605, Pierce County, Washington",72,29
850,14,50,25,48,29,10,1500000US530530605002,"Block Group 2, Census Tract 605, Pierce County, Washington",79,35
981,28,35,8,48,0,17,1500000US530530605003,"Block Group 3, Census Tract 605, Pierce County, Washington",35,25
556,0,29,35,0,0,60,1500000US530530605004,"Block Group 4, Census Tract 605, Pierce County, Washington",29,95
882,15,42,48,14,24,32,1500000US530530605005,"Block Group 5, Census Tract 605, Pierce County, Washington",66,80
1124,0,31,34,15,16,35,1500000US530530606001,"Block Group 1, Census Tract 606, Pierce County, Washington",47,69
1255,36,0,66,0,25,31,1500000US530530606002,"Block Group 2, Census Tract 606, Pierce County, Washington",25,97
816,32,36,0,0,15,47,1500000US530530606003,"Block Group 3, Census Tract 606, Pierce County, Washington",51,47
1194,41,12,26,16,16,25,1500000US530530606004,"Block Group 4, Census Tract 606, Pierce County, Washington",28,51
571,0,28,0,31,46,0,1500000US530530606005,"Block Group 5, Census Tract 606, Pierce County, Washington",74,0
619,12,23,15,0,29,13,1500000US530530606006,"Block Group 6, Census Tract 606, Pierce County, Washington",52,28
1136,45,0,43,87,33,12,1500000US530530607001,"Block Group 1, Census Tract 607, Pierce County, Washington",33,55
982,9,22,54,0,22,33,1500000US530530607002,"Block Group 2, Census Tract 607, Pierce County, Washington",44,87
1265,69,17,10,42,19,14,1500000US530530607003,"Block Group 3, Census Tract 607, Pierce County, Washington",36,24
816,61,7,0,0,0,8,1500000US530530607004,"Block Group 4, Census Tract 607, Pierce County, Washington",7,8
1485,0,0,8,0,9,0,1500000US530530607005,"Block Group 5, Census Tract 607, Pierce County, Washington",9,8
698,29,15,0,18,0,0,1500000US530530607006,"Block Group 6, Census Tract 607, Pierce County, Washington",15,0
765,0,53,38,14,20,21,1500000US530530608001,"Block Group 1, Census Tract 608, Pierce County, Washington",73,59
643,14,0,12,0,26,0,1500000US530530608002,"Block Group 2, Census Tract 608, Pierce County, Washington",26,12
739,13,59,57,0,18,0,1500000US530530608003,"Block Group 3, Census Tract 608, Pierce County, Washington",77,57
527,0,0,59,16,0,17,1500000US530530608004,"Block Group 4, Census Tract 608, Pierce County, Washington",0,76
850,0,77,0,65,0,65,1500000US530530608005,"Block Group 5, Census Tract 608, Pierce County, Washington",77,65
1037,15,0,139,0,0,30,1500000US530530608006,"Block Group 6, Census Tract 608, Pierce County, Washington",0,169
588,14,15,0,14,0,28,1500000US530530608007,"Block Group 7, Census Tract 608, Pierce County, Washington",15,28
1083,77,54,114,57,35,124,1500000US530530609031,"Block Group 1, Census Tract 609.03, Pierce County, Washington",89,238
1008,0,12,15,18,26,12,1500000US530530609032,"Block Group 2, Census Tract 609.03, Pierce County, Washington",38,27
1248,32,30,0,17,66,34,1500000US530530609033,"Block Group 3, Census Tract 609.03, Pierce County, Washington",96,34
650,0,14,65,47,0,0,1500000US530530609041,"Block Group 1, Census Tract 609.04, Pierce County, Washington",14,65
2406,205,65,20,106,105,67,1500000US530530609042,"Block Group 2, Census Tract 609.04, Pierce County, Washington",170,87
750,8,0,30,50,31,8,1500000US530530609043,"Block Group 3, Census Tract 609.04, Pierce County, Washington",31,38
1260,17,29,47,14,25,30,1500000US530530609044,"Block Group 4, Census Tract 609.04, Pierce County, Washington",54,77
1961,61,39,61,190,0,0,1500000US530530609051,"Block Group 1, Census Tract 609.05, Pierce County, Washington",39,61
854,0,0,0,15,0,0,1500000US530530609052,"Block Group 2, Census Tract 609.05, Pierce County, Washington",0,0
781,27,23,0,9,17,50,1500000US530530609053,"Block Group 3, Census Tract 609.05, Pierce County, Washington",40,50
1736,93,17,53,111,17,55,1500000US530530609054,"Block Group 4, Census Tract 609.05, Pierce County, Washington",34,108
1105,0,18,0,0,18,0,1500000US530530609055,"Block Group 5, Census Tract 609.05, Pierce County, Washington",36,0
1632,23,34,43,7,46,19,1500000US530530609061,"Block Group 1, Census Tract 609.06, Pierce County, Washington",80,62
723,42,32,8,24,23,12,1500000US530530609062,"Block Group 2, Census Tract 609.06, Pierce County, Washington",55,20
1017,45,33,10,20,0,10,1500000US530530610011,"Block Group 1, Census Tract 610.01, Pierce County, Washington",33,20
803,0,22,27,0,12,10,1500000US530530610012,"Block Group 2, Census Tract 610.01, Pierce County, Washington",34,37
1875,17,43,44,55,53,7,1500000US530530610013,"Block Group 3, Census Tract 610.01, Pierce County, Washington",96,51
1813,33,66,50,76,136,1,1500000US530530610021,"Block Group 1, Census Tract 610.02, Pierce County, Washington",202,51
836,25,0,81,0,0,25,1500000US530530610022,"Block Group 2, Census Tract 610.02, Pierce County, Washington",0,106
938,0,0,0,0,0,0,1500000US530530610023,"Block Group 3, Census Tract 610.02, Pierce County, Washington",0,0
605,47,0,0,32,0,0,1500000US530530610024,"Block Group 4, Census Tract 610.02, Pierce County, Washington",0,0
1299,16,68,135,0,18,38,1500000US530530611001,"Block Group 1, Census Tract 611, Pierce County, Washington",86,173
494,75,18,0,18,15,0,1500000US530530611002,"Block Group 2, Census Tract 611, Pierce County, Washington",33,0
784,0,44,13,56,45,13,1500000US530530611003,"Block Group 3, Census Tract 611, Pierce County, Washington",89,26
779,0,0,0,0,0,0,1500000US530530611004,"Block Group 4, Census Tract 611, Pierce County, Washington",0,0
1103,66,0,0,83,36,60,1500000US530530611005,"Block Group 5, Census Tract 611, Pierce County, Washington",36,60
1442,54,0,42,70,24,91,1500000US530530611006,"Block Group 6, Census Tract 611, Pierce County, Washington",24,133
1033,35,28,18,0,18,45,1500000US530530611007,"Block Group 7, Census Tract 611, Pierce County, Washington",46,63
1896,137,144,102,42,79,0,1500000US530530612001,"Block Group 1, Census Tract 612, Pierce County, Washington",223,102
595,21,21,12,19,11,0,1500000US530530612002,"Block Group 2, Census Tract 612, Pierce County, Washington",32,12
794,51,81,33,39,0,0,1500000US530530612003,"Block Group 3, Census Tract 612, Pierce County, Washington",81,33
896,0,0,27,45,13,13,1500000US530530612004,"Block Group 4, Census Tract 612, Pierce County, Washington",13,40
677,7,12,0,32,7,10,1500000US530530612005,"Block Group 5, Census Tract 612, Pierce County, Washington",19,10
844,53,0,10,39,8,43,1500000US530530612006,"Block Group 6, Census Tract 612, Pierce County, Washington",8,53
670,13,19,15,0,11,9,1500000US530530613001,"Block Group 1, Census Tract 613, Pierce County, Washington",30,24
1074,45,64,65,55,24,47,1500000US530530613002,"Block Group 2, Census Tract 613, Pierce County, Washington",88,112
913,17,0,45,0,27,45,1500000US530530613003,"Block Group 3, Census Tract 613, Pierce County, Washington",27,90
672,0,0,72,78,31,14,1500000US530530613004,"Block Group 4, Census Tract 613, Pierce County, Washington",31,86
749,23,21,0,22,32,26,1500000US530530613005,"Block Group 5, Census Tract 613, Pierce County, Washington",53,26
898,52,33,51,34,82,0,1500000US530530613006,"Block Group 6, Census Tract 613, Pierce County, Washington",115,51
967,14,29,60,16,19,13,1500000US530530614001,"Block Group 1, Census Tract 614, Pierce County, Washington",48,73
1878,58,16,8,0,0,9,1500000US530530614002,"Block Group 2, Census Tract 614, Pierce County, Washington",16,17
1213,28,51,57,53,10,97,1500000US530530614003,"Block Group 3, Census Tract 614, Pierce County, Washington",61,154
1555,32,0,0,14,0,16,1500000US530530615001,"Block Group 1, Census Tract 615, Pierce County, Washington",0,16
1539,113,0,22,0,15,19,1500000US530530615002,"Block Group 2, Census Tract 615, Pierce County, Washington",15,41
878,0,15,0,15,0,0,1500000US530530615003,"Block Group 3, Census Tract 615, Pierce County, Washington",15,0
990,0,0,1,22,30,29,1500000US530530615004,"Block Group 4, Census Tract 615, Pierce County, Washington",30,30
1900,33,15,21,8,0,0,1500000US530530616011,"Block Group 1, Census Tract 616.01, Pierce County, Washington",15,21
867,10,0,16,0,43,20,1500000US530530616021,"Block Group 1, Census Tract 616.02, Pierce County, Washington",43,36
1012,10,22,0,138,28,12,1500000US530530617001,"Block Group 1, Census Tract 617, Pierce County, Washington",50,12
800,47,33,114,54,65,36,1500000US530530617002,"Block Group 2, Census Tract 617, Pierce County, Washington",98,150
907,67,102,26,22,0,16,1500000US530530617003,"Block Group 3, Census Tract 617, Pierce County, Washington",102,42
496,0,9,8,0,0,0,1500000US530530617004,"Block Group 4, Census Tract 617, Pierce County, Washington",9,8
939,49,0,57,32,0,0,1500000US530530617005,"Block Group 5, Census Tract 617, Pierce County, Washington",0,57
1089,15,48,53,116,27,58,1500000US530530618001,"Block Group 1, Census Tract 618, Pierce County, Washington",75,111
1017,44,6,71,72,31,0,1500000US530530618002,"Block Group 2, Census Tract 618, Pierce County, Washington",37,71
434,8,0,0,25,11,11,1500000US530530618003,"Block Group 3, Census Tract 618, Pierce County, Washington",11,11
876,18,0,42,50,16,22,1500000US530530619001,"Block Group 1, Census Tract 619, Pierce County, Washington",16,64
950,34,17,22,23,5,0,1500000US530530619002,"Block Group 2, Census Tract 619, Pierce County, Washington",22,22
871,0,0,14,26,15,45,1500000US530530620001,"Block Group 1, Census Tract 620, Pierce County, Washington",15,59
1146,47,35,30,92,58,72,1500000US530530620002,"Block Group 2, Census Tract 620, Pierce County, Washington",93,102
1048,56,61,58,57,8,31,1500000US530530620003,"Block Group 3, Census Tract 620, Pierce County, Washington",69,89
1307,78,36,43,49,17,21,1500000US530530620004,"Block Group 4, Census Tract 620, Pierce County, Washington",53,64
1377,26,74,18,55,45,30,1500000US530530623001,"Block Group 1, Census Tract 623, Pierce County, Washington",119,48
1740,135,73,82,133,67,63,1500000US530530623002,"Block Group 2, Census Tract 623, Pierce County, Washington",140,145
1332,34,66,85,47,60,48,1500000US530530623003,"Block Group 3, Census Tract 623, Pierce County, Washington",126,133
919,7,14,12,28,24,19,1500000US530530623004,"Block Group 4, Census Tract 623, Pierce County, Washington",38,31
1436,120,0,35,27,0,16,1500000US530530624001,"Block Group 1, Census Tract 624, Pierce County, Washington",0,51
896,42,12,49,58,32,0,1500000US530530624002,"Block Group 2, Census Tract 624, Pierce County, Washington",44,49
1177,25,103,88,30,25,22,1500000US530530624003,"Block Group 3, Census Tract 624, Pierce County, Washington",128,110
1102,24,22,8,0,64,0,1500000US530530624004,"Block Group 4, Census Tract 624, Pierce County, Washington",86,8
840,16,72,58,0,53,0,1500000US530530624005,"Block Group 5, Census Tract 624, Pierce County, Washington",125,58
1339,105,54,78,1,82,61,1500000US530530625001,"Block Group 1, Census Tract 625, Pierce County, Washington",136,139
1835,101,21,58,64,19,220,1500000US530530625002,"Block Group 2, Census Tract 625, Pierce County, Washington",40,278
559,6,0,6,25,0,0,1500000US530530625003,"Block Group 3, Census Tract 625, Pierce County, Washington",0,6
1114,46,107,15,0,47,47,1500000US530530625004,"Block Group 4, Census Tract 625, Pierce County, Washington",154,62
1626,0,12,43,100,61,119,1500000US530530625005,"Block Group 5, Census Tract 625, Pierce County, Washington",73,162
740,15,0,0,0,0,0,1500000US530530625006,"Block Group 6, Census Tract 625, Pierce County, Washington",0,0
974,0,37,53,0,57,69,1500000US530530625007,"Block Group 7, Census Tract 625, Pierce County, Washington",94,122
1024,0,22,31,43,91,0,1500000US530530626001,"Block Group 1, Census Tract 626, Pierce County, Washington",113,31
1996,90,76,25,146,109,28,1500000US530530626002,"Block Group 2, Census Tract 626, Pierce County, Washington",185,53
1092,12,43,0,46,40,0,1500000US530530628011,"Block Group 1, Census Tract 628.01, Pierce County, Washington",83,0
2157,135,99,109,68,145,163,1500000US530530628012,"Block Group 2, Census Tract 628.01, Pierce County, Washington",244,272
1979,124,0,24,60,82,15,1500000US530530628013,"Block Group 3, Census Tract 628.01, Pierce County, Washington",82,39
1065,137,0,0,0,14,0,1500000US530530628014,"Block Group 4, Census Tract 628.01, Pierce County, Washington",14,0
1706,103,26,63,34,74,92,1500000US530530628021,"Block Group 1, Census Tract 628.02, Pierce County, Washington",100,155
1435,113,41,12,0,14,51,1500000US530530628022,"Block Group 2, Census Tract 628.02, Pierce County, Washington",55,63
1057,53,8,0,40,0,61,1500000US530530628023,"Block Group 3, Census Tract 628.02, Pierce County, Washington",8,61
2724,93,47,136,140,57,61,1500000US530530629001,"Block Group 1, Census Tract 629, Pierce County, Washington",104,197
1338,24,56,16,88,23,50,1500000US530530629002,"Block Group 2, Census Tract 629, Pierce County, Washington",79,66
957,15,15,20,15,14,0,1500000US530530629003,"Block Group 3, Census Tract 629, Pierce County, Washington",29,20
771,42,0,0,13,13,12,1500000US530530629004,"Block Group 4, Census Tract 629, Pierce County, Washington",13,12
733,27,58,0,29,52,28,1500000US530530629005,"Block Group 5, Census Tract 629, Pierce County, Washington",110,28
748,52,0,11,14,41,44,1500000US530530629006,"Block Group 6, Census Tract 629, Pierce County, Washington",41,55
1158,26,12,35,38,49,46,1500000US530530630001,"Block Group 1, Census Tract 630, Pierce County, Washington",61,81
1963,111,19,59,54,47,76,1500000US530530630002,"Block Group 2, Census Tract 630, Pierce County, Washington",66,135
643,8,17,21,30,8,17,1500000US530530631001,"Block Group 1, Census Tract 631, Pierce County, Washington",25,38
1259,109,54,24,52,49,61,1500000US530530631002,"Block Group 2, Census Tract 631, Pierce County, Washington",103,85
991,86,107,28,61,25,0,1500000US530530631003,"Block Group 3, Census Tract 631, Pierce County, Washington",132,28
1475,26,47,19,69,36,55,1500000US530530631004,"Block Group 4, Census Tract 631, Pierce County, Washington",83,74
923,17,20,29,32,14,20,1500000US530530632001,"Block Group 1, Census Tract 632, Pierce County, Washington",34,49
2048,60,81,46,46,128,53,1500000US530530632002,"Block Group 2, Census Tract 632, Pierce County, Washington",209,99
767,34,29,73,39,0,10,1500000US530530632003,"Block Group 3, Census Tract 632, Pierce County, Washington",29,83
798,7,39,0,78,38,29,1500000US530530632004,"Block Group 4, Census Tract 632, Pierce County, Washington",77,29
720,26,9,16,16,12,11,1500000US530530632005,"Block Group 5, Census Tract 632, Pierce County, Washington",21,27
1541,66,69,31,91,50,28,1500000US530530633001,"Block Group 1, Census Tract 633, Pierce County, Washington",119,59
3070,154,337,115,182,76,103,1500000US530530633002,"Block Group 2, Census Tract 633, Pierce County, Washington",413,218
1399,13,29,22,36,51,22,1500000US530530633003,"Block Group 3, Census Tract 633, Pierce County, Washington",80,44
1137,103,51,56,18,63,5,1500000US530530633004,"Block Group 4, Census Tract 633, Pierce County, Washington",114,61
1172,78,58,37,62,15,79,1500000US530530633005,"Block Group 5, Census Tract 633, Pierce County, Washington",73,116
1601,188,105,8,0,234,72,1500000US530530634001,"Block Group 1, Census Tract 634, Pierce County, Washington",339,80
1726,58,151,60,19,106,75,1500000US530530634002,"Block Group 2, Census Tract 634, Pierce County, Washington",257,135
763,18,34,20,0,4,47,1500000US530530634003,"Block Group 3, Census Tract 634, Pierce County, Washington",38,67
612,0,0,0,18,33,15,1500000US530530634004,"Block Group 4, Census Tract 634, Pierce County, Washington",33,15
1459,80,141,64,49,75,0,1500000US530530634005,"Block Group 5, Census Tract 634, Pierce County, Washington",216,64
1268,89,35,0,60,59,98,1500000US530530634006,"Block Group 6, Census Tract 634, Pierce County, Washington",94,98
717,33,10,83,0,10,11,1500000US530530635011,"Block Group 1, Census Tract 635.01, Pierce County, Washington",20,94
944,34,16,26,10,27,42,1500000US530530635012,"Block Group 2, Census Tract 635.01, Pierce County, Washington",43,68
958,15,23,34,27,0,16,1500000US530530635013,"Block Group 3, Census Tract 635.01, Pierce County, Washington",23,50
1732,86,0,94,54,149,42,1500000US530530635014,"Block Group 4, Census Tract 635.01, Pierce County, Washington",149,136
1003,12,0,94,36,15,34,1500000US530530635021,"Block Group 1, Census Tract 635.02, Pierce County, Washington",15,128
2442,49,78,79,91,79,54,1500000US530530635022,"Block Group 2, Census Tract 635.02, Pierce County, Washington",157,133
1499,56,28,42,35,5,136,1500000US530530635023,"Block Group 3, Census Tract 635.02, Pierce County, Washington",33,178
730,19,9,23,11,5,14,1500000US530530701001,"Block Group 1, Census Tract 701, Pierce County, Washington",14,37
0,0,0,0,0,0,0,1500000US530530701002,"Block Group 2, Census Tract 701, Pierce County, Washington",0,0
1364,111,50,56,49,41,83,1500000US530530701003,"Block Group 3, Census Tract 701, Pierce County, Washington",91,139
1240,47,35,48,35,7,31,1500000US530530701004,"Block Group 4, Census Tract 701, Pierce County, Washington",42,79
2384,100,132,133,113,135,70,1500000US530530702031,"Block Group 1, Census Tract 702.03, Pierce County, Washington",267,203
2483,64,109,211,37,37,95,1500000US530530702032,"Block Group 2, Census Tract 702.03, Pierce County, Washington",146,306
717,35,19,13,0,65,35,1500000US530530702033,"Block Group 3, Census Tract 702.03, Pierce County, Washington",84,48
1691,77,84,29,147,50,121,1500000US530530702041,"Block Group 1, Census Tract 702.04, Pierce County, Washington",134,150
2080,164,116,33,58,37,21,1500000US530530702042,"Block Group 2, Census Tract 702.04, Pierce County, Washington",153,54
2241,77,92,51,25,78,72,1500000US530530702051,"Block Group 1, Census Tract 702.05, Pierce County, Washington",170,123
952,17,7,66,5,6,87,1500000US530530702052,"Block Group 2, Census Tract 702.05, Pierce County, Washington",13,153
1534,41,60,76,18,27,68,1500000US530530702061,"Block Group 1, Census Tract 702.06, Pierce County, Washington",87,144
1285,40,28,84,2,49,18,1500000US530530702062,"Block Group 2, Census Tract 702.06, Pierce County, Washington",77,102
998,14,26,91,6,13,35,1500000US530530702063,"Block Group 3, Census Tract 702.06, Pierce County, Washington",39,126
1330,0,22,33,41,9,151,1500000US530530702071,"Block Group 1, Census Tract 702.07, Pierce County, Washington",31,184
1125,54,32,20,22,11,67,1500000US530530702072,"Block Group 2, Census Tract 702.07, Pierce County, Washington",43,87
1115,49,0,60,20,37,10,1500000US530530702073,"Block Group 3, Census Tract 702.07, Pierce County, Washington",37,70
1276,82,0,41,9,41,71,1500000US530530702074,"Block Group 4, Census Tract 702.07, Pierce County, Washington",41,112
975,37,92,44,53,31,65,1500000US530530703071,"Block Group 1, Census Tract 703.07, Pierce County, Washington",123,109
1818,45,54,55,22,38,139,1500000US530530703072,"Block Group 2, Census Tract 703.07, Pierce County, Washington",92,194
2332,29,132,70,25,71,159,1500000US530530703073,"Block Group 3, Census Tract 703.07, Pierce County, Washington",203,229
1636,20,90,31,29,61,76,1500000US530530703081,"Block Group 1, Census Tract 703.08, Pierce County, Washington",151,107
1727,138,64,6,90,76,30,1500000US530530703082,"Block Group 2, Census Tract 703.08, Pierce County, Washington",140,36
1229,14,0,43,32,33,16,1500000US530530703091,"Block Group 1, Census Tract 703.09, Pierce County, Washington",33,59
2031,43,63,69,99,94,102,1500000US530530703092,"Block Group 2, Census Tract 703.09, Pierce County, Washington",157,171
1967,107,68,63,108,106,52,1500000US530530703093,"Block Group 3, Census Tract 703.09, Pierce County, Washington",174,115
1884,31,41,120,35,22,59,1500000US530530703101,"Block Group 1, Census Tract 703.10, Pierce County, Washington",63,179
780,15,74,9,30,10,0,1500000US530530703102,"Block Group 2, Census Tract 703.10, Pierce County, Washington",84,9
1891,145,91,89,77,81,138,1500000US530530703103,"Block Group 3, Census Tract 703.10, Pierce County, Washington",172,227
675,5,7,11,39,17,37,1500000US530530703104,"Block Group 4, Census Tract 703.10, Pierce County, Washington",24,48
1386,28,80,51,65,53,126,1500000US530530703111,"Block Group 1, Census Tract 703.11, Pierce County, Washington",133,177
1512,0,53,59,156,53,27,1500000US530530703112,"Block Group 2, Census Tract 703.11, Pierce County, Washington",106,86
2174,73,77,189,124,135,137,1500000US530530703113,"Block Group 3, Census Tract 703.11, Pierce County, Washington",212,326
965,47,28,72,20,66,72,1500000US530530703121,"Block Group 1, Census Tract 703.12, Pierce County, Washington",94,144
3148,122,89,141,144,60,231,1500000US530530703122,"Block Group 2, Census Tract 703.12, Pierce County, Washington",149,372
1362,35,37,69,100,54,165,1500000US530530703123,"Block Group 3, Census Tract 703.12, Pierce County, Washington",91,234
1343,38,10,15,33,73,59,1500000US530530703131,"Block Group 1, Census Tract 703.13, Pierce County, Washington",83,74
932,61,67,0,20,10,23,1500000US530530703132,"Block Group 2, Census Tract 703.13, Pierce County, Washington",77,23
1597,28,45,31,22,31,0,1500000US530530703133,"Block Group 3, Census Tract 703.13, Pierce County, Washington",76,31
597,75,0,42,0,0,0,1500000US530530703134,"Block Group 4, Census Tract 703.13, Pierce County, Washington",0,42
915,0,9,49,28,10,15,1500000US530530703135,"Block Group 5, Census Tract 703.13, Pierce County, Washington",19,64
2038,54,132,28,194,21,43,1500000US530530703141,"Block Group 1, Census Tract 703.14, Pierce County, Washington",153,71
1125,32,23,31,16,24,46,1500000US530530703142,"Block Group 2, Census Tract 703.14, Pierce County, Washington",47,77
1391,38,15,14,14,74,12,1500000US530530703151,"Block Group 1, Census Tract 703.15, Pierce County, Washington",89,26
1372,59,53,70,98,77,103,1500000US530530703152,"Block Group 2, Census Tract 703.15, Pierce County, Washington",130,173
1601,80,76,50,52,56,36,1500000US530530703153,"Block Group 3, Census Tract 703.15, Pierce County, Washington",132,86
836,45,88,16,0,101,8,1500000US530530703154,"Block Group 4, Census Tract 703.15, Pierce County, Washington",189,24
1617,76,0,68,113,57,0,1500000US530530703161,"Block Group 1, Census Tract 703.16, Pierce County, Washington",57,68
3411,167,180,89,65,49,107,1500000US530530703162,"Block Group 2, Census Tract 703.16, Pierce County, Washington",229,196
1546,26,68,87,33,90,56,1500000US530530704011,"Block Group 1, Census Tract 704.01, Pierce County, Washington",158,143
671,31,38,0,13,23,12,1500000US530530704012,"Block Group 2, Census Tract 704.01, Pierce County, Washington",61,12
918,2,20,46,2,14,30,1500000US530530704031,"Block Group 1, Census Tract 704.03, Pierce County, Washington",34,76
723,60,20,0,19,23,0,1500000US530530704032,"Block Group 2, Census Tract 704.03, Pierce County, Washington",43,0
1956,0,144,31,47,50,85,1500000US530530704033,"Block Group 3, Census Tract 704.03, Pierce County, Washington",194,116
2739,198,190,73,151,181,251,1500000US530530704041,"Block Group 1, Census Tract 704.04, Pierce County, Washington",371,324
2083,103,137,41,76,29,121,1500000US530530704042,"Block Group 2, Census Tract 704.04, Pierce County, Washington",166,162
843,38,18,18,41,22,27,1500000US530530707031,"Block Group 1, Census Tract 707.03, Pierce County, Washington",40,45
1568,42,53,0,19,19,23,1500000US530530707032,"Block Group 2, Census Tract 707.03, Pierce County, Washington",72,23
1793,87,108,15,60,99,79,1500000US530530707033,"Block Group 3, Census Tract 707.03, Pierce County, Washington",207,94
1015,22,27,36,75,30,66,1500000US530530707034,"Block Group 4, Census Tract 707.03, Pierce County, Washington",57,102
938,3,31,26,55,11,11,1500000US530530707035,"Block Group 5, Census Tract 707.03, Pierce County, Washington",42,37
1296,37,34,14,37,11,59,1500000US530530711001,"Block Group 1, Census Tract 711, Pierce County, Washington",45,73
1002,7,23,43,7,16,25,1500000US530530711002,"Block Group 2, Census Tract 711, Pierce County, Washington",39,68
1753,58,67,52,39,17,63,1500000US530530712051,"Block Group 1, Census Tract 712.05, Pierce County, Washington",84,115
2963,73,169,93,71,23,147,1500000US530530712052,"Block Group 2, Census Tract 712.05, Pierce County, Washington",192,240
1003,14,14,26,36,32,60,1500000US530530712061,"Block Group 1, Census Tract 712.06, Pierce County, Washington",46,86
1002,17,14,0,47,59,32,1500000US530530712062,"Block Group 2, Census Tract 712.06, Pierce County, Washington",73,32
2215,152,144,75,60,56,17,1500000US530530712063,"Block Group 3, Census Tract 712.06, Pierce County, Washington",200,92
2679,135,172,47,62,18,121,1500000US530530712064,"Block Group 4, Census Tract 712.06, Pierce County, Washington",190,168
1225,50,28,39,35,37,25,1500000US530530712071,"Block Group 1, Census Tract 712.07, Pierce County, Washington",65,64
2742,79,50,56,210,20,219,1500000US530530712072,"Block Group 2, Census Tract 712.07, Pierce County, Washington",70,275
2505,0,16,112,227,30,57,1500000US530530712073,"Block Group 3, Census Tract 712.07, Pierce County, Washington",46,169
1610,11,46,11,29,63,12,1500000US530530712081,"Block Group 1, Census Tract 712.08, Pierce County, Washington",109,23
2274,11,41,63,54,58,41,1500000US530530712082,"Block Group 2, Census Tract 712.08, Pierce County, Washington",99,104
3519,219,136,236,166,271,92,1500000US530530712083,"Block Group 3, Census Tract 712.08, Pierce County, Washington",407,328
2516,23,93,95,60,46,116,1500000US530530712091,"Block Group 1, Census Tract 712.09, Pierce County, Washington",139,211
730,28,38,27,12,21,66,1500000US530530712092,"Block Group 2, Census Tract 712.09, Pierce County, Washington",59,93
900,30,16,44,20,34,8,1500000US530530712093,"Block Group 3, Census Tract 712.09, Pierce County, Washington",50,52
450,8,20,0,24,0,24,1500000US530530712101,"Block Group 1, Census Tract 712.10, Pierce County, Washington",20,24
1130,25,42,69,23,4,20,1500000US530530712102,"Block Group 2, Census Tract 712.10, Pierce County, Washington",46,89
2639,78,22,101,113,20,129,1500000US530530712103,"Block Group 3, Census Tract 712.10, Pierce County, Washington",42,230
2359,62,43,68,173,51,59,1500000US530530713041,"Block Group 1, Census Tract 713.04, Pierce County, Washington",94,127
2514,85,157,209,14,44,80,1500000US530530713042,"Block Group 2, Census Tract 713.04, Pierce County, Washington",201,289
822,15,0,0,15,0,15,1500000US530530713043,"Block Group 3, Census Tract 713.04, Pierce County, Washington",0,15
2065,132,44,44,62,67,62,1500000US530530713051,"Block Group 1, Census Tract 713.05, Pierce County, Washington",111,106
1708,26,49,36,33,37,114,1500000US530530713052,"Block Group 2, Census Tract 713.05, Pierce County, Washington",86,150
1327,63,16,0,14,90,88,1500000US530530713061,"Block Group 1, Census Tract 713.06, Pierce County, Washington",106,88
1313,49,51,27,61,20,20,1500000US530530713062,"Block Group 2, Census Tract 713.06, Pierce County, Washington",71,47
2726,110,239,88,41,144,137,1500000US530530713063,"Block Group 3, Census Tract 713.06, Pierce County, Washington",383,225
1104,46,30,18,31,63,0,1500000US530530713064,"Block Group 4, Census Tract 713.06, Pierce County, Washington",93,18
1494,58,43,32,53,46,75,1500000US530530713071,"Block Group 1, Census Tract 713.07, Pierce County, Washington",89,107
1116,40,48,6,125,53,70,1500000US530530713072,"Block Group 2, Census Tract 713.07, Pierce County, Washington",101,76
2002,81,83,99,63,68,83,1500000US530530713073,"Block Group 3, Census Tract 713.07, Pierce County, Washington",151,182
1560,61,66,13,43,41,46,1500000US530530713091,"Block Group 1, Census Tract 713.09, Pierce County, Washington",107,59
1460,34,55,78,57,9,42,1500000US530530713092,"Block Group 2, Census Tract 713.09, Pierce County, Washington",64,120
1211,85,54,0,51,50,46,1500000US530530713093,"Block Group 3, Census Tract 713.09, Pierce County, Washington",104,46
2184,107,124,46,112,47,66,1500000US530530713101,"Block Group 1, Census Tract 713.10, Pierce County, Washington",171,112
2846,105,101,129,83,102,129,1500000US530530713102,"Block Group 2, Census Tract 713.10, Pierce County, Washington",203,258
1355,25,8,36,0,18,0,1500000US530530714031,"Block Group 1, Census Tract 714.03, Pierce County, Washington",26,36
855,46,18,5,14,0,28,1500000US530530714032,"Block Group 2, Census Tract 714.03, Pierce County, Washington",18,33
1665,166,15,48,97,95,43,1500000US530530714033,"Block Group 3, Census Tract 714.03, Pierce County, Washington",110,91
3339,237,145,151,136,118,169,1500000US530530714061,"Block Group 1, Census Tract 714.06, Pierce County, Washington",263,320
1357,96,0,2,0,0,15,1500000US530530714062,"Block Group 2, Census Tract 714.06, Pierce County, Washington",0,17
585,14,15,27,7,18,24,1500000US530530714063,"Block Group 3, Census Tract 714.06, Pierce County, Washington",33,51
1925,74,114,142,15,31,54,1500000US530530714064,"Block Group 4, Census Tract 714.06, Pierce County, Washington",145,196
1459,127,71,0,61,80,47,1500000US530530714071,"Block Group 1, Census Tract 714.07, Pierce County, Washington",151,47
1422,17,28,28,11,29,15,1500000US530530714072,"Block Group 2, Census Tract 714.07, Pierce County, Washington",57,43
1848,66,37,77,131,37,18,1500000US530530714073,"Block Group 3, Census Tract 714.07, Pierce County, Washington",74,95
2073,99,112,97,85,116,102,1500000US530530714074,"Block Group 4, Census Tract 714.07, Pierce County, Washington",228,199
1889,35,64,60,37,48,21,1500000US530530714081,"Block Group 1, Census Tract 714.08, Pierce County, Washington",112,81
1182,11,87,24,39,21,14,1500000US530530714082,"Block Group 2, Census Tract 714.08, Pierce County, Washington",108,38
834,17,29,67,26,50,51,1500000US530530714083,"Block Group 3, Census Tract 714.08, Pierce County, Washington",79,118
1206,13,37,33,28,52,132,1500000US530530714091,"Block Group 1, Census Tract 714.09, Pierce County, Washington",89,165
853,61,120,27,28,15,9,1500000US530530714092,"Block Group 2, Census Tract 714.09, Pierce County, Washington",135,36
1596,83,56,52,65,147,70,1500000US530530714093,"Block Group 3, Census Tract 714.09, Pierce County, Washington",203,122
982,76,94,61,50,38,42,1500000US530530714094,"Block Group 4, Census Tract 714.09, Pierce County, Washington",132,103
1524,60,174,10,0,24,33,1500000US530530714101,"Block Group 1, Census Tract 714.10, Pierce County, Washington",198,43
1589,35,159,144,71,85,19,1500000US530530714102,"Block Group 2, Census Tract 714.10, Pierce County, Washington",244,163
2043,78,104,69,12,67,47,1500000US530530714103,"Block Group 3, Census Tract 714.10, Pierce County, Washington",171,116
1711,125,52,38,101,53,33,1500000US530530714104,"Block Group 4, Census Tract 714.10, Pierce County, Washington",105,71
2591,105,113,198,111,192,150,1500000US530530714111,"Block Group 1, Census Tract 714.11, Pierce County, Washington",305,348
925,54,33,0,86,44,42,1500000US530530714112,"Block Group 2, Census Tract 714.11, Pierce County, Washington",77,42
1623,99,80,36,41,42,95,1500000US530530714113,"Block Group 3, Census Tract 714.11, Pierce County, Washington",122,131
1706,17,109,0,37,34,14,1500000US530530715031,"Block Group 1, Census Tract 715.03, Pierce County, Washington",143,14
1816,47,77,177,71,24,133,1500000US530530715032,"Block Group 2, Census Tract 715.03, Pierce County, Washington",101,310
595,0,0,12,20,0,0,1500000US530530715033,"Block Group 3, Census Tract 715.03, Pierce County, Washington",0,12
1295,0,51,55,0,26,8,1500000US530530715034,"Block Group 4, Census Tract 715.03, Pierce County, Washington",77,63
1679,77,62,73,48,41,25,1500000US530530715041,"Block Group 1, Census Tract 715.04, Pierce County, Washington",103,98
2262,16,0,7,14,13,55,1500000US530530715042,"Block Group 2, Census Tract 715.04, Pierce County, Washington",13,62
919,8,0,32,33,33,0,1500000US530530715043,"Block Group 3, Census Tract 715.04, Pierce County, Washington",33,32
800,0,0,17,20,19,49,1500000US530530715044,"Block Group 4, Census Tract 715.04, Pierce County, Washington",19,66
1782,73,81,77,58,35,77,1500000US530530715051,"Block Group 1, Census Tract 715.05, Pierce County, Washington",116,154
871,39,13,9,34,11,91,1500000US530530715052,"Block Group 2, Census Tract 715.05, Pierce County, Washington",24,100
1034,0,0,22,29,56,16,1500000US530530715053,"Block Group 3, Census Tract 715.05, Pierce County, Washington",56,38
1453,7,37,36,22,23,27,1500000US530530715054,"Block Group 4, Census Tract 715.05, Pierce County, Washington",60,63
1093,25,4,29,0,5,59,1500000US530530715061,"Block Group 1, Census Tract 715.06, Pierce County, Washington",9,88
2153,64,83,56,17,56,78,1500000US530530715062,"Block Group 2, Census Tract 715.06, Pierce County, Washington",139,134
1756,14,22,17,46,104,188,1500000US530530715063,"Block Group 3, Census Tract 715.06, Pierce County, Washington",126,205
3096,119,171,125,155,59,97,1500000US530530716011,"Block Group 1, Census Tract 716.01, Pierce County, Washington",230,222
1700,6,52,86,14,21,132,1500000US530530716012,"Block Group 2, Census Tract 716.01, Pierce County, Washington",73,218
2071,62,197,141,43,39,77,1500000US530530716021,"Block Group 1, Census Tract 716.02, Pierce County, Washington",236,218
1632,0,32,22,123,8,43,1500000US530530716022,"Block Group 2, Census Tract 716.02, Pierce County, Washington",40,65
1935,23,74,59,91,24,140,1500000US530530716023,"Block Group 3, Census Tract 716.02, Pierce County, Washington",98,199
895,71,7,0,79,39,0,1500000US530530716024,"Block Group 4, Census Tract 716.02, Pierce County, Washington",46,0
2132,176,86,58,86,46,76,1500000US530530717031,"Block Group 1, Census Tract 717.03, Pierce County, Washington",132,134
1374,41,35,46,60,10,11,1500000US530530717032,"Block Group 2, Census Tract 717.03, Pierce County, Washington",45,57
2842,330,128,129,305,106,63,1500000US530530717041,"Block Group 1, Census Tract 717.04, Pierce County, Washington",234,192
1417,100,109,10,166,109,54,1500000US530530717042,"Block Group 2, Census Tract 717.04, Pierce County, Washington",218,64
786,104,33,45,47,43,0,1500000US530530717043,"Block Group 3, Census Tract 717.04, Pierce County, Washington",76,45
1511,137,46,94,14,51,51,1500000US530530717051,"Block Group 1, Census Tract 717.05, Pierce County, Washington",97,145
1314,27,37,42,31,79,69,1500000US530530717052,"Block Group 2, Census Tract 717.05, Pierce County, Washington",116,111
1274,98,60,23,24,59,83,1500000US530530717053,"Block Group 3, Census Tract 717.05, Pierce County, Washington",119,106
1821,55,91,59,12,72,42,1500000US530530717061,"Block Group 1, Census Tract 717.06, Pierce County, Washington",163,101
813,22,25,21,8,9,9,1500000US530530717071,"Block Group 1, Census Tract 717.07, Pierce County, Washington",34,30
898,89,43,0,24,37,31,1500000US530530717072,"Block Group 2, Census Tract 717.07, Pierce County, Washington",80,31
1102,45,8,58,11,68,27,1500000US530530717073,"Block Group 3, Census Tract 717.07, Pierce County, Washington",76,85
1437,14,78,0,65,14,98,1500000US530530718031,"Block Group 1, Census Tract 718.03, Pierce County, Washington",92,98
2410,113,0,64,0,71,202,1500000US530530718032,"Block Group 2, Census Tract 718.03, Pierce County, Washington",71,266
737,10,12,9,52,62,0,1500000US530530718033,"Block Group 3, Census Tract 718.03, Pierce County, Washington",74,9
823,0,0,45,46,45,44,1500000US530530718034,"Block Group 4, Census Tract 718.03, Pierce County, Washington",45,89
823,4,4,0,60,32,22,1500000US530530718051,"Block Group 1, Census Tract 718.05, Pierce County, Washington",36,22
1367,47,40,24,108,132,9,1500000US530530718052,"Block Group 2, Census Tract 718.05, Pierce County, Washington",172,33
1915,68,180,0,112,0,9,1500000US530530718053,"Block Group 3, Census Tract 718.05, Pierce County, Washington",180,9
2535,98,89,56,213,125,85,1500000US530530718061,"Block Group 1, Census Tract 718.06, Pierce County, Washington",214,141
1582,68,21,0,49,103,41,1500000US530530718062,"Block Group 2, Census Tract 718.06, Pierce County, Washington",124,41
2050,156,76,48,65,52,34,1500000US530530718071,"Block Group 1, Census Tract 718.07, Pierce County, Washington",128,82
1547,33,52,52,66,14,65,1500000US530530718072,"Block Group 2, Census Tract 718.07, Pierce County, Washington",66,117
1528,150,0,28,119,57,58,1500000US530530718081,"Block Group 1, Census Tract 718.08, Pierce County, Washington",57,86
1540,20,23,0,0,0,12,1500000US530530718082,"Block Group 2, Census Tract 718.08, Pierce County, Washington",23,12
641,45,56,0,60,0,22,1500000US530530718083,"Block Group 3, Census Tract 718.08, Pierce County, Washington",56,22
1799,100,79,58,140,90,26,1500000US530530719011,"Block Group 1, Census Tract 719.01, Pierce County, Washington",169,84
643,0,0,14,17,0,0,1500000US530530719012,"Block Group 2, Census Tract 719.01, Pierce County, Washington",0,14
1039,0,23,22,24,12,12,1500000US530530719013,"Block Group 3, Census Tract 719.01, Pierce County, Washington",35,34
1269,30,29,56,16,15,17,1500000US530530719014,"Block Group 4, Census Tract 719.01, Pierce County, Washington",44,73
1408,29,78,64,50,41,0,1500000US530530719021,"Block Group 1, Census Tract 719.02, Pierce County, Washington",119,64
936,33,0,0,41,12,23,1500000US530530719022,"Block Group 2, Census Tract 719.02, Pierce County, Washington",12,23
1000,0,0,10,14,12,11,1500000US530530719023,"Block Group 3, Census Tract 719.02, Pierce County, Washington",12,21
632,0,42,0,0,29,0,1500000US530530719024,"Block Group 4, Census Tract 719.02, Pierce County, Washington",71,0
1022,0,21,10,0,11,9,1500000US530530719025,"Block Group 5, Census Tract 719.02, Pierce County, Washington",32,19
1248,16,55,187,57,0,107,1500000US530530720001,"Block Group 1, Census Tract 720, Pierce County, Washington",55,294
1596,26,97,103,81,81,75,1500000US530530720002,"Block Group 2, Census Tract 720, Pierce County, Washington",178,178
1013,119,0,34,30,77,0,1500000US530530720003,"Block Group 3, Census Tract 720, Pierce County, Washington",77,34
778,55,0,32,46,49,0,1500000US530530720004,"Block Group 4, Census Tract 720, Pierce County, Washington",49,32
1204,25,12,26,0,30,32,1500000US530530721051,"Block Group 1, Census Tract 721.05, Pierce County, Washington",42,58
1919,130,44,37,146,71,23,1500000US530530721052,"Block Group 2, Census Tract 721.05, Pierce County, Washington",115,60
984,0,0,0,0,0,0,1500000US530530721053,"Block Group 3, Census Tract 721.05, Pierce County, Washington",0,0
1511,0,6,50,9,12,18,1500000US530530721054,"Block Group 4, Census Tract 721.05, Pierce County, Washington",18,68
696,16,0,0,0,0,0,1500000US530530721061,"Block Group 1, Census Tract 721.06, Pierce County, Washington",0,0
1898,0,53,98,29,0,50,1500000US530530721062,"Block Group 2, Census Tract 721.06, Pierce County, Washington",53,148
2422,117,149,57,91,10,3,1500000US530530721063,"Block Group 3, Census Tract 721.06, Pierce County, Washington",159,60
1389,16,38,0,31,64,28,1500000US530530721064,"Block Group 4, Census Tract 721.06, Pierce County, Washington",102,28
1242,24,44,22,48,40,53,1500000US530530721071,"Block Group 1, Census Tract 721.07, Pierce County, Washington",84,75
1298,0,26,10,23,38,14,1500000US530530721072,"Block Group 2, Census Tract 721.07, Pierce County, Washington",64,24
1042,55,30,66,0,53,20,1500000US530530721073,"Block Group 3, Census Tract 721.07, Pierce County, Washington",83,86
630,18,58,0,9,9,36,1500000US530530721074,"Block Group 4, Census Tract 721.07, Pierce County, Washington",67,36
697,35,39,0,11,0,13,1500000US530530721081,"Block Group 1, Census Tract 721.08, Pierce County, Washington",39,13
951,0,16,26,0,62,8,1500000US530530721082,"Block Group 2, Census Tract 721.08, Pierce County, Washington",78,34
517,13,17,11,15,10,36,1500000US530530721083,"Block Group 3, Census Tract 721.08, Pierce County, Washington",27,47
2290,35,125,96,57,136,260,1500000US530530721084,"Block Group 4, Census Tract 721.08, Pierce County, Washington",261,356
1214,0,29,16,13,31,76,1500000US530530721085,"Block Group 5, Census Tract 721.08, Pierce County, Washington",60,92
1590,38,69,24,82,45,10,1500000US530530721091,"Block Group 1, Census Tract 721.09, Pierce County, Washington",114,34
2007,38,64,18,45,33,16,1500000US530530721092,"Block Group 2, Census Tract 721.09, Pierce County, Washington",97,34
1270,87,22,9,59,34,62,1500000US530530721111,"Block Group 1, Census Tract 721.11, Pierce County, Washington",56,71
1174,53,84,33,35,18,0,1500000US530530721112,"Block Group 2, Census Tract 721.11, Pierce County, Washington",102,33
1862,59,25,97,25,31,25,1500000US530530721121,"Block Group 1, Census Tract 721.12, Pierce County, Washington",56,122
1284,41,64,9,12,13,84,1500000US530530721122,"Block Group 2, Census Tract 721.12, Pierce County, Washington",77,93
1142,56,16,30,22,33,31,1500000US530530721123,"Block Group 3, Census Tract 721.12, Pierce County, Washington",49,61
1234,42,27,34,45,15,16,1500000US530530723051,"Block Group 1, Census Tract 723.05, Pierce County, Washington",42,50
987,34,15,96,14,15,99,1500000US530530723052,"Block Group 2, Census Tract 723.05, Pierce County, Washington",30,195
818,32,0,21,46,36,29,1500000US530530723053,"Block Group 3, Census Tract 723.05, Pierce County, Washington",36,50
886,0,22,103,55,73,0,1500000US530530723054,"Block Group 4, Census Tract 723.05, Pierce County, Washington",95,103
1493,32,38,37,76,54,19,1500000US530530723055,"Block Group 5, Census Tract 723.05, Pierce County, Washington",92,56
554,0,0,0,0,0,17,1500000US530530723056,"Block Group 6, Census Tract 723.05, Pierce County, Washington",0,17
1843,22,25,66,52,36,157,1500000US530530723071,"Block Group 1, Census Tract 723.07, Pierce County, Washington",61,223
656,19,0,25,53,0,0,1500000US530530723072,"Block Group 2, Census Tract 723.07, Pierce County, Washington",0,25
732,30,7,36,0,0,42,1500000US530530723073,"Block Group 3, Census Tract 723.07, Pierce County, Washington",7,78
1064,44,10,71,18,41,24,1500000US530530723074,"Block Group 4, Census Tract 723.07, Pierce County, Washington",51,95
1272,74,7,36,0,0,97,1500000US530530723081,"Block Group 1, Census Tract 723.08, Pierce County, Washington",7,133
2043,118,65,126,42,71,171,1500000US530530723082,"Block Group 2, Census Tract 723.08, Pierce County, Washington",136,297
1128,10,14,90,38,29,0,1500000US530530723083,"Block Group 3, Census Tract 723.08, Pierce County, Washington",43,90
1670,55,0,62,140,80,50,1500000US530530723084,"Block Group 4, Census Tract 723.08, Pierce County, Washington",80,112
1728,16,0,168,51,45,46,1500000US530530723085,"Block Group 5, Census Tract 723.08, Pierce County, Washington",45,214
1579,57,12,28,31,0,58,1500000US530530723091,"Block Group 1, Census Tract 723.09, Pierce County, Washington",12,86
1819,121,104,36,102,38,53,1500000US530530723092,"Block Group 2, Census Tract 723.09, Pierce County, Washington",142,89
1285,44,13,0,47,69,14,1500000US530530723093,"Block Group 3, Census Tract 723.09, Pierce County, Washington",82,14
910,0,0,8,27,32,34,1500000US530530723094,"Block Group 4, Census Tract 723.09, Pierce County, Washington",32,42
1003,27,19,26,51,35,0,1500000US530530723101,"Block Group 1, Census Tract 723.10, Pierce County, Washington",54,26
684,0,30,0,25,11,44,1500000US530530723102,"Block Group 2, Census Tract 723.10, Pierce County, Washington",41,44
2006,51,40,67,63,84,85,1500000US530530723103,"Block Group 3, Census Tract 723.10, Pierce County, Washington",124,152
1380,51,0,49,6,51,38,1500000US530530723111,"Block Group 1, Census Tract 723.11, Pierce County, Washington",51,87
1184,48,19,76,49,52,52,1500000US530530723112,"Block Group 2, Census Tract 723.11, Pierce County, Washington",71,128
1776,46,48,73,28,68,159,1500000US530530723113,"Block Group 3, Census Tract 723.11, Pierce County, Washington",116,232
2648,76,69,93,105,55,72,1500000US530530723121,"Block Group 1, Census Tract 723.12, Pierce County, Washington",124,165
1337,22,21,91,25,31,14,1500000US530530723122,"Block Group 2, Census Tract 723.12, Pierce County, Washington",52,105
1658,97,23,19,134,139,0,1500000US530530723123,"Block Group 3, Census Tract 723.12, Pierce County, Washington",162,19
2132,67,25,90,57,50,148,1500000US530530723131,"Block Group 1, Census Tract 723.13, Pierce County, Washington",75,238
1381,107,9,39,7,14,44,1500000US530530723132,"Block Group 2, Census Tract 723.13, Pierce County, Washington",23,83
1900,21,22,89,52,35,86,1500000US530530724051,"Block Group 1, Census Tract 724.05, Pierce County, Washington",57,175
2443,31,107,101,68,49,94,1500000US530530724052,"Block Group 2, Census Tract 724.05, Pierce County, Washington",156,195
2038,70,107,82,33,84,119,1500000US530530724061,"Block Group 1, Census Tract 724.06, Pierce County, Washington",191,201
2001,9,97,173,140,37,32,1500000US530530724062,"Block Group 2, Census Tract 724.06, Pierce County, Washington",134,205
2146,93,44,54,95,118,53,1500000US530530724063,"Block Group 3, Census Tract 724.06, Pierce County, Washington",162,107
1624,70,17,13,30,0,0,1500000US530530724071,"Block Group 1, Census Tract 724.07, Pierce County, Washington",17,13
1570,0,10,115,37,18,0,1500000US530530724072,"Block Group 2, Census Tract 724.07, Pierce County, Washington",28,115
1519,28,77,95,30,94,126,1500000US530530724073,"Block Group 3, Census Tract 724.07, Pierce County, Washington",171,221
1252,31,15,29,38,15,27,1500000US530530724081,"Block Group 1, Census Tract 724.08, Pierce County, Washington",30,56
2083,51,67,129,0,32,42,1500000US530530724082,"Block Group 2, Census Tract 724.08, Pierce County, Washington",99,171
1068,26,0,28,27,18,18,1500000US530530724083,"Block Group 3, Census Tract 724.08, Pierce County, Washington",18,46
1504,75,63,97,48,17,28,1500000US530530724084,"Block Group 4, Census Tract 724.08, Pierce County, Washington",80,125
1454,31,47,66,40,20,86,1500000US530530724091,"Block Group 1, Census Tract 724.09, Pierce County, Washington",67,152
1072,0,63,25,0,35,43,1500000US530530724092,"Block Group 2, Census Tract 724.09, Pierce County, Washington",98,68
1911,16,52,25,58,50,59,1500000US530530724101,"Block Group 1, Census Tract 724.10, Pierce County, Washington",102,84
1645,47,35,42,33,108,25,1500000US530530724102,"Block Group 2, Census Tract 724.10, Pierce County, Washington",143,67
1809,51,20,45,28,19,32,1500000US530530725031,"Block Group 1, Census Tract 725.03, Pierce County, Washington",39,77
2583,118,68,161,16,64,79,1500000US530530725032,"Block Group 2, Census Tract 725.03, Pierce County, Washington",132,240
1939,37,87,111,57,79,25,1500000US530530725041,"Block Group 1, Census Tract 725.04, Pierce County, Washington",166,136
3126,34,100,64,112,125,89,1500000US530530725042,"Block Group 2, Census Tract 725.04, Pierce County, Washington",225,153
1315,64,59,34,63,29,0,1500000US530530725051,"Block Group 1, Census Tract 725.05, Pierce County, Washington",88,34
1425,71,0,12,38,46,62,1500000US530530725052,"Block Group 2, Census Tract 725.05, Pierce County, Washington",46,74
3366,75,129,77,94,43,96,1500000US530530725053,"Block Group 3, Census Tract 725.05, Pierce County, Washington",172,173
1148,10,20,11,0,52,168,1500000US530530725054,"Block Group 4, Census Tract 725.05, Pierce County, Washington",72,179
1143,27,25,40,31,29,48,1500000US530530725061,"Block Group 1, Census Tract 725.06, Pierce County, Washington",54,88
2262,18,76,76,28,87,102,1500000US530530725062,"Block Group 2, Census Tract 725.06, Pierce County, Washington",163,178
664,0,0,14,28,0,0,1500000US530530725071,"Block Group 1, Census Tract 725.07, Pierce County, Washington",0,14
1875,54,54,29,26,31,9,1500000US530530725072,"Block Group 2, Census Tract 725.07, Pierce County, Washington",85,38
2503,54,48,43,16,60,136,1500000US530530726011,"Block Group 1, Census Tract 726.01, Pierce County, Washington",108,179
1093,33,7,41,0,20,0,1500000US530530726012,"Block Group 2, Census Tract 726.01, Pierce County, Washington",27,41
1761,44,94,107,56,85,46,1500000US530530726013,"Block Group 3, Census Tract 726.01, Pierce County, Washington",179,153
948,21,29,43,10,19,21,1500000US530530726021,"Block Group 1, Census Tract 726.02, Pierce County, Washington",48,64
2044,35,36,169,18,46,70,1500000US530530726022,"Block Group 2, Census Tract 726.02, Pierce County, Washington",82,239
1354,0,22,1,86,28,120,1500000US530530726023,"Block Group 3, Census Tract 726.02, Pierce County, Washington",50,121
783,27,16,67,16,0,0,1500000US530530726031,"Block Group 1, Census Tract 726.03, Pierce County, Washington",16,67
966,65,43,8,0,42,0,1500000US530530726032,"Block Group 2, Census Tract 726.03, Pierce County, Washington",85,8
877,0,0,0,0,0,0,1500000US530530726033,"Block Group 3, Census Tract 726.03, Pierce County, Washington",0,0
1643,126,54,83,54,39,40,1500000US530530726034,"Block Group 4, Census Tract 726.03, Pierce County, Washington",93,123
701,0,0,0,0,0,0,1500000US530530726035,"Block Group 5, Census Tract 726.03, Pierce County, Washington",0,0
5671,371,310,194,177,326,284,1500000US530530728001,"Block Group 1, Census Tract 728, Pierce County, Washington",636,478
3335,300,98,88,170,125,156,1500000US530530728002,"Block Group 2, Census Tract 728, Pierce County, Washington",223,244
3167,304,251,81,212,214,106,1500000US530530729011,"Block Group 1, Census Tract 729.01, Pierce County, Washington",465,187
3454,212,244,81,95,137,122,1500000US530530729031,"Block Group 1, Census Tract 729.03, Pierce County, Washington",381,203
3063,427,122,108,225,102,75,1500000US530530729051,"Block Group 1, Census Tract 729.05, Pierce County, Washington",224,183
1382,204,171,83,170,66,35,1500000US530530729052,"Block Group 2, Census Tract 729.05, Pierce County, Washington",237,118
1621,233,118,100,164,44,36,1500000US530530729053,"Block Group 3, Census Tract 729.05, Pierce County, Washington",162,136
1015,0,0,0,0,0,0,1500000US530530729061,"Block Group 1, Census Tract 729.06, Pierce County, Washington",0,0
962,4,0,13,0,35,0,1500000US530530729062,"Block Group 2, Census Tract 729.06, Pierce County, Washington",35,13
2044,180,131,8,189,229,36,1500000US530530729071,"Block Group 1, Census Tract 729.07, Pierce County, Washington",360,44
3922,352,238,293,403,385,143,1500000US530530729072,"Block Group 2, Census Tract 729.07, Pierce County, Washington",623,436
0,0,0,0,0,0,0,1500000US530530729073,"Block Group 3, Census Tract 729.07, Pierce County, Washington",0,0
912,15,34,6,0,54,42,1500000US530530730011,"Block Group 1, Census Tract 730.01, Pierce County, Washington",88,48
1048,0,59,0,42,35,14,1500000US530530730012,"Block Group 2, Census Tract 730.01, Pierce County, Washington",94,14
1646,102,53,56,51,0,68,1500000US530530730013,"Block Group 3, Census Tract 730.01, Pierce County, Washington",53,124
1251,10,15,42,89,47,58,1500000US530530730014,"Block Group 4, Census Tract 730.01, Pierce County, Washington",62,100
1038,66,37,48,29,11,23,1500000US530530730015,"Block Group 5, Census Tract 730.01, Pierce County, Washington",48,71
1051,0,0,77,0,0,26,1500000US530530730051,"Block Group 1, Census Tract 730.05, Pierce County, Washington",0,103
1254,18,32,19,0,6,43,1500000US530530730052,"Block Group 2, Census Tract 730.05, Pierce County, Washington",38,62
1093,62,26,26,0,86,49,1500000US530530730053,"Block Group 3, Census Tract 730.05, Pierce County, Washington",112,75
2036,60,109,43,60,43,149,1500000US530530730054,"Block Group 4, Census Tract 730.05, Pierce County, Washington",152,192
2472,43,115,82,79,24,55,1500000US530530730061,"Block Group 1, Census Tract 730.06, Pierce County, Washington",139,137
1011,49,24,16,36,22,35,1500000US530530730062,"Block Group 2, Census Tract 730.06, Pierce County, Washington",46,51
2322,8,32,163,86,102,57,1500000US530530731081,"Block Group 1, Census Tract 731.08, Pierce County, Washington",134,220
3604,89,124,161,160,109,61,1500000US530530731082,"Block Group 2, Census Tract 731.08, Pierce County, Washington",233,222
2097,82,152,75,163,75,48,1500000US530530731083,"Block Group 3, Census Tract 731.08, Pierce County, Washington",227,123
1769,38,58,28,57,53,64,1500000US530530731101,"Block Group 1, Census Tract 731.10, Pierce County, Washington",111,92
2033,0,64,79,36,71,90,1500000US530530731102,"Block Group 2, Census Tract 731.10, Pierce County, Washington",135,169
1986,48,38,165,49,67,63,1500000US530530731111,"Block Group 1, Census Tract 731.11, Pierce County, Washington",105,228
1395,9,45,53,66,116,46,1500000US530530731112,"Block Group 2, Census Tract 731.11, Pierce County, Washington",161,99
780,19,26,43,20,17,68,1500000US530530731113,"Block Group 3, Census Tract 731.11, Pierce County, Washington",43,111
1817,36,33,0,13,46,65,1500000US530530731131,"Block Group 1, Census Tract 731.13, Pierce County, Washington",79,65
2604,151,175,66,118,132,181,1500000US530530731132,"Block Group 2, Census Tract 731.13, Pierce County, Washington",307,247
2537,101,169,146,127,156,150,1500000US530530731133,"Block Group 3, Census Tract 731.13, Pierce County, Washington",325,296
2408,18,108,160,90,60,135,1500000US530530731141,"Block Group 1, Census Tract 731.14, Pierce County, Washington",168,295
1821,56,135,103,115,23,63,1500000US530530731142,"Block Group 2, Census Tract 731.14, Pierce County, Washington",158,166
1271,33,25,39,39,55,97,1500000US530530731143,"Block Group 3, Census Tract 731.14, Pierce County, Washington",80,136
2100,86,81,80,27,51,111,1500000US530530731151,"Block Group 1, Census Tract 731.15, Pierce County, Washington",132,191
1517,46,77,65,11,57,40,1500000US530530731152,"Block Group 2, Census Tract 731.15, Pierce County, Washington",134,105
474,0,0,23,0,10,0,1500000US530530731153,"Block Group 3, Census Tract 731.15, Pierce County, Washington",10,23
2195,99,71,163,94,53,93,1500000US530530731161,"Block Group 1, Census Tract 731.16, Pierce County, Washington",124,256
1082,0,12,54,37,27,6,1500000US530530731162,"Block Group 2, Census Tract 731.16, Pierce County, Washington",39,60
2012,63,144,27,48,45,41,1500000US530530731171,"Block Group 1, Census Tract 731.17, Pierce County, Washington",189,68
1856,0,72,77,0,41,176,1500000US530530731172,"Block Group 2, Census Tract 731.17, Pierce County, Washington",113,253
1910,49,50,101,24,51,109,1500000US530530731181,"Block Group 1, Census Tract 731.18, Pierce County, Washington",101,210
2373,63,122,54,71,68,106,1500000US530530731182,"Block Group 2, Census Tract 731.18, Pierce County, Washington",190,160
827,0,9,39,18,2,0,1500000US530530731191,"Block Group 1, Census Tract 731.19, Pierce County, Washington",11,39
2289,57,25,96,34,67,28,1500000US530530731192,"Block Group 2, Census Tract 731.19, Pierce County, Washington",92,124
2254,82,60,84,121,179,87,1500000US530530731201,"Block Group 1, Census Tract 731.20, Pierce County, Washington",239,171
2110,136,127,49,116,17,144,1500000US530530731202,"Block Group 2, Census Tract 731.20, Pierce County, Washington",144,193
2324,46,47,279,29,109,144,1500000US530530731211,"Block Group 1, Census Tract 731.21, Pierce County, Washington",156,423
2754,122,76,59,194,53,74,1500000US530530731212,"Block Group 2, Census Tract 731.21, Pierce County, Washington",129,133
1338,40,14,69,56,59,50,1500000US530530731221,"Block Group 1, Census Tract 731.22, Pierce County, Washington",73,119
2954,136,23,133,155,183,191,1500000US530530731222,"Block Group 2, Census Tract 731.22, Pierce County, Washington",206,324
3226,34,172,220,130,62,87,1500000US530530731231,"Block Group 1, Census Tract 731.23, Pierce County, Washington",234,307
1651,26,9,178,107,106,79,1500000US530530731232,"Block Group 2, Census Tract 731.23, Pierce County, Washington",115,257
940,0,0,61,66,0,77,1500000US530530731241,"Block Group 1, Census Tract 731.24, Pierce County, Washington",0,138
2580,130,149,101,110,174,32,1500000US530530731242,"Block Group 2, Census Tract 731.24, Pierce County, Washington",323,133
4449,188,254,363,249,182,144,1500000US530530731251,"Block Group 1, Census Tract 731.25, Pierce County, Washington",436,507
1599,41,45,88,109,44,88,1500000US530530731252,"Block Group 2, Census Tract 731.25, Pierce County, Washington",89,176
3573,240,107,177,123,44,287,1500000US530530731253,"Block Group 3, Census Tract 731.25, Pierce County, Washington",151,464
4173,133,249,249,207,305,285,1500000US530530731261,"Block Group 1, Census Tract 731.26, Pierce County, Washington",554,534
1355,58,35,15,48,127,83,1500000US530530732001,"Block Group 1, Census Tract 732, Pierce County, Washington",162,98
826,70,2,0,27,23,23,1500000US530530732002,"Block Group 2, Census Tract 732, Pierce County, Washington",25,23
1326,21,38,82,27,49,54,1500000US530530732003,"Block Group 3, Census Tract 732, Pierce County, Washington",87,136
2032,69,23,13,50,106,51,1500000US530530732004,"Block Group 4, Census Tract 732, Pierce County, Washington",129,64
3367,83,110,181,237,163,109,1500000US530530733011,"Block Group 1, Census Tract 733.01, Pierce County, Washington",273,290
1331,30,87,61,64,56,114,1500000US530530733012,"Block Group 2, Census Tract 733.01, Pierce County, Washington",143,175
207,0,0,0,12,12,0,1500000US530530733013,"Block Group 3, Census Tract 733.01, Pierce County, Washington",12,0
983,15,0,0,124,67,15,1500000US530530733014,"Block Group 4, Census Tract 733.01, Pierce County, Washington",67,15
1261,10,74,20,75,22,19,1500000US530530733021,"Block Group 1, Census Tract 733.02, Pierce County, Washington",96,39
1316,24,64,57,55,25,49,1500000US530530733022,"Block Group 2, Census Tract 733.02, Pierce County, Washington",89,106
1155,11,20,21,46,0,80,1500000US530530733023,"Block Group 3, Census Tract 733.02, Pierce County, Washington",20,101
1338,10,72,42,39,21,21,1500000US530530734041,"Block Group 1, Census Tract 734.04, Pierce County, Washington",93,63
899,47,9,9,0,35,21,1500000US530530734042,"Block Group 2, Census Tract 734.04, Pierce County, Washington",44,30
706,53,0,9,0,0,0,1500000US530530734043,"Block Group 3, Census Tract 734.04, Pierce County, Washington",0,9
1034,46,12,0,0,12,49,1500000US530530734044,"Block Group 4, Census Tract 734.04, Pierce County, Washington",24,49
1873,48,50,86,27,49,78,1500000US530530734045,"Block Group 5, Census Tract 734.04, Pierce County, Washington",99,164
1933,61,54,64,32,79,55,1500000US530530734051,"Block Group 1, Census Tract 734.05, Pierce County, Washington",133,119
1431,0,25,23,49,41,27,1500000US530530734052,"Block Group 2, Census Tract 734.05, Pierce County, Washington",66,50
1715,18,28,56,40,71,55,1500000US530530734061,"Block Group 1, Census Tract 734.06, Pierce County, Washington",99,111
1458,52,61,0,45,41,43,1500000US530530734062,"Block Group 2, Census Tract 734.06, Pierce County, Washington",102,43
1851,90,128,54,20,46,40,1500000US530530734063,"Block Group 3, Census Tract 734.06, Pierce County, Washington",174,94
1483,101,21,48,43,18,0,1500000US530530734071,"Block Group 1, Census Tract 734.07, Pierce County, Washington",39,48
943,22,85,43,0,62,20,1500000US530530734072,"Block Group 2, Census Tract 734.07, Pierce County, Washington",147,63
1309,68,62,2,40,0,0,1500000US530530734073,"Block Group 3, Census Tract 734.07, Pierce County, Washington",62,2
2181,156,118,84,179,114,77,1500000US530530734081,"Block Group 1, Census Tract 734.08, Pierce County, Washington",232,161
994,14,15,7,11,47,46,1500000US530530734082,"Block Group 2, Census Tract 734.08, Pierce County, Washington",62,53
826,6,38,21,7,0,19,1500000US530530734083,"Block Group 3, Census Tract 734.08, Pierce County, Washington",38,40
1185,34,19,0,16,17,20,1500000US530530735001,"Block Group 1, Census Tract 735, Pierce County, Washington",36,20
1282,58,51,12,13,0,24,1500000US530530735002,"Block Group 2, Census Tract 735, Pierce County, Washington",51,36
1052,55,37,28,7,29,10,1500000US530530735003,"Block Group 3, Census Tract 735, Pierce County, Washington",66,38
919,0,0,31,32,39,18,1500000US530530735004,"Block Group 4, Census Tract 735, Pierce County, Washington",39,49
1365,25,0,55,71,28,92,1500000US530530735005,"Block Group 5, Census Tract 735, Pierce County, Washington",28,147
1406,20,100,83,32,49,75,1500000US530530735006,"Block Group 6, Census Tract 735, Pierce County, Washington",149,158
1378,17,42,67,39,24,68,1500000US530539400011,"Block Group 1, Census Tract 9400.01, Pierce County, Washington",66,135
1303,43,6,26,58,22,29,1500000US530539400012,"Block Group 2, Census Tract 9400.01, Pierce County, Washington",28,55
1494,43,55,50,25,59,66,1500000US530539400021,"Block Group 1, Census Tract 9400.02, Pierce County, Washington",114,116
1163,31,22,72,66,29,19,1500000US530539400022,"Block Group 2, Census Tract 9400.02, Pierce County, Washington",51,91
1130,32,42,56,21,35,68,1500000US530539400023,"Block Group 3, Census Tract 9400.02, Pierce County, Washington",77,124
3340,129,116,157,194,154,64,1500000US530539400031,"Block Group 1, Census Tract 9400.03, Pierce County, Washington",270,221
1605,43,53,10,34,42,56,1500000US530539400032,"Block Group 2, Census Tract 9400.03, Pierce County, Washington",95,66
2228,100,105,100,111,109,67,1500000US530539400033,"Block Group 3, Census Tract 9400.03, Pierce County, Washington",214,167
1467,37,47,40,30,46,14,1500000US530539400041,"Block Group 1, Census Tract 9400.04, Pierce County, Washington",93,54
559,4,25,19,0,21,44,1500000US530539400042,"Block Group 2, Census Tract 9400.04, Pierce County, Washington",46,63
852,13,3,27,22,3,6,1500000US530539400043,"Block Group 3, Census Tract 9400.04, Pierce County, Washington",6,33
805,7,0,15,12,29,39,1500000US530539400044,"Block Group 4, Census Tract 9400.04, Pierce County, Washington",29,54
1240,13,50,28,22,27,22,1500000US530539400045,"Block Group 5, Census Tract 9400.04, Pierce County, Washington",77,50
1434,3,21,51,13,32,40,1500000US530539400046,"Block Group 6, Census Tract 9400.04, Pierce County, Washington",53,91
1509,49,61,46,47,34,53,1500000US530539400051,"Block Group 1, Census Tract 9400.05, Pierce County, Washington",95,99
2127,65,70,72,58,58,104,1500000US530539400052,"Block Group 2, Census Tract 9400.05, Pierce County, Washington",128,176
2226,123,107,78,58,43,123,1500000US530539400053,"Block Group 3, Census Tract 9400.05, Pierce County, Washington",150,201
1526,95,77,105,39,82,80,1500000US530539400061,"Block Group 1, Census Tract 9400.06, Pierce County, Washington",159,185
1351,89,157,67,95,175,101,1500000US530539400062,"Block Group 2, Census Tract 9400.06, Pierce County, Washington",332,168
752,14,61,34,17,12,25,1500000US530539400071,"Block Group 1, Census Tract 9400.07, Pierce County, Washington",73,59
1238,41,19,15,90,36,26,1500000US530539400072,"Block Group 2, Census Tract 9400.07, Pierce County, Washington",55,41
1135,67,44,53,30,38,46,1500000US530539400073,"Block Group 3, Census Tract 9400.07, Pierce County, Washington",82,99
2786,90,94,110,55,69,88,1500000US530539400081,"Block Group 1, Census Tract 9400.08, Pierce County, Washington",163,198
2044,78,146,95,68,122,80,1500000US530539400082,"Block Group 2, Census Tract 9400.08, Pierce County, Washington",268,175
1266,8,23,41,23,10,25,1500000US530539400083,"Block Group 3, Census Tract 9400.08, Pierce County, Washington",33,66
1751,29,12,46,69,40,34,1500000US530539400091,"Block Group 1, Census Tract 9400.09, Pierce County, Washington",52,80
1083,10,54,25,59,8,44,1500000US530539400092,"Block Group 2, Census Tract 9400.09, Pierce County, Washington",62,69
1944,56,42,28,66,43,37,1500000US530539400101,"Block Group 1, Census Tract 9400.10, Pierce County, Washington",85,65
1555,0,50,15,0,23,12,1500000US530539400102,"Block Group 2, Census Tract 9400.10, Pierce County, Washington",73,27
606,11,50,23,9,3,33,1500000US530539400103,"Block Group 3, Census Tract 9400.10, Pierce County, Washington",53,56
1458,21,28,60,35,28,68,1500000US530539400111,"Block Group 1, Census Tract 9400.11, Pierce County, Washington",56,128
1802,74,47,46,25,63,43,1500000US530539400112,"Block Group 2, Census Tract 9400.11, Pierce County, Washington",110,89
1014,19,32,49,11,33,21,1500000US530539400113,"Block Group 3, Census Tract 9400.11, Pierce County, Washington",65,70
